111111111111111111111
000000000000000000001
111111111111111111101
111111100000000001101
111111101101111111101
100000001100000000001
101111111111111111101
100000000111100000001
101111111111111111111
10000000000000000000X
111111111111111111111